+++++++++++++++++++++++ 
+   +   ++ ++     +     
+ +   +       +++ + +++ 
+ + +  ++  ++++   + +++ 
+++ ++++++    +++ +  ++ 
+          ++  ++    ++ 
+++++ ++++++   +++++ ++ 
+     +   +++++++  + ++ 
+ +++++++      S +   ++ 
+                + ++++ 
++++++++++++++++++ ++++ 